1111111111111
1C010C00000C1
1100011111001
1P1C11E0000B1
1111111111111