1111111111111
1C110C00000C1
1100011111001
1P0C11E0000B1
1111111111111 