1111111111111111111111111111111111
1E0000B00000000C00000C000000000001
1010010100100000101001000000010101
1B10010010101010001001000B00010101
1P0000000C00C0000000000B00000000C1
1111111111111111111111111111111111