1111111111111111111111111
1E000B00000000C00000C0001
1010101001000001010010001
1B10100101010100010010001
1P000000C00C0000000000BC1
1111111111111111111111111