1111111111111
1C010C00000C1
1000011111001
1P0C11E0000B1
1111111111111