1111111111111
1C010C00000C1
1000011110011
1P0C11E0001B1
1111111111111