1111111111111
1CB10C00000C1
1000011110111
1P0C11E000101
1111111111111